find: "\s([a-zA-Z]+)=[^;]+;"
replace: " \1=ProphecyAstTokenType\.\1\.getCode\(\);"


		public static final int EOF=ProphecyAstTokenType.EOF.getCode();
	public static final int ADD=ProphecyAstTokenType.ADD.getCode();
	public static final int ASSIGMENT=ProphecyAstTokenType.ASSIGMENT.getCode();
	public static final int BITAND=ProphecyAstTokenType.BITAND.getCode();
	public static final int BITOR=ProphecyAstTokenType.BITOR.getCode();
	public static final int BITXOR=ProphecyAstTokenType.BITXOR.getCode();
	public static final int BLOCK=ProphecyAstTokenType.BLOCK.getCode();
	public static final int CALL=ProphecyAstTokenType.CALL.getCode();
	public static final int CAST=ProphecyAstTokenType.CAST.getCode();
	public static final int CHARLIT=ProphecyAstTokenType.CHARLIT.getCode();
	public static final int CLASSDEF=ProphecyAstTokenType.CLASSDEF.getCode();
	public static final int DEFBLOCK=ProphecyAstTokenType.DEFBLOCK.getCode();
	public static final int DIV=ProphecyAstTokenType.DIV.getCode();
	public static final int EQ=ProphecyAstTokenType.EQ.getCode();
	public static final int EXPR=ProphecyAstTokenType.EXPR.getCode();
	public static final int EXPRLIST=ProphecyAstTokenType.EXPRLIST.getCode();
	public static final int FIELDDEF=ProphecyAstTokenType.FIELDDEF.getCode();
	public static final int FILE=ProphecyAstTokenType.FILE.getCode();
	public static final int FLOATLIT=ProphecyAstTokenType.FLOATLIT.getCode();
	public static final int GT=ProphecyAstTokenType.GT.getCode();
	public static final int GTE=ProphecyAstTokenType.GTE.getCode();
	public static final int ID=ProphecyAstTokenType.ID.getCode();
	public static final int IF=ProphecyAstTokenType.IF.getCode();
	public static final int INDEX=ProphecyAstTokenType.INDEX.getCode();
	public static final int INTLIT=ProphecyAstTokenType.INTLIT.getCode();
	public static final int LOGICAND=ProphecyAstTokenType.LOGICAND.getCode();
	public static final int LOGICOR=ProphecyAstTokenType.LOGICOR.getCode();
	public static final int LT=ProphecyAstTokenType.LT.getCode();
	public static final int LTE=ProphecyAstTokenType.LTE.getCode();
	public static final int MEMBER=ProphecyAstTokenType.MEMBER.getCode();
	public static final int METHODDEF=ProphecyAstTokenType.METHODDEF.getCode();
	public static final int MODIFIERLIST=ProphecyAstTokenType.MODIFIERLIST.getCode();
	public static final int MUL=ProphecyAstTokenType.MUL.getCode();
	public static final int NEQ=ProphecyAstTokenType.NEQ.getCode();
	public static final int PARAM=ProphecyAstTokenType.PARAM.getCode();
	public static final int PARAMLIST=ProphecyAstTokenType.PARAMLIST.getCode();
	public static final int POSTDEC=ProphecyAstTokenType.POSTDEC.getCode();
	public static final int POSTINC=ProphecyAstTokenType.POSTINC.getCode();
	public static final int PREDEC=ProphecyAstTokenType.PREDEC.getCode();
	public static final int PREINC=ProphecyAstTokenType.PREINC.getCode();
	public static final int RETURN=ProphecyAstTokenType.RETURN.getCode();
	public static final int SHIFTL=ProphecyAstTokenType.SHIFTL.getCode();
	public static final int SHIFTR=ProphecyAstTokenType.SHIFTR.getCode();
	public static final int STRINGLIT=ProphecyAstTokenType.STRINGLIT.getCode();
	public static final int SUB=ProphecyAstTokenType.SUB.getCode();
	public static final int TRUELIT=ProphecyAstTokenType.TRUELIT.getCode();
	public static final int UBITNOT=ProphecyAstTokenType.UBITNOT.getCode();
	public static final int ULOGICNOT=ProphecyAstTokenType.ULOGICNOT.getCode();
	public static final int UMINUS=ProphecyAstTokenType.UMINUS.getCode();
	public static final int UPLUS=ProphecyAstTokenType.UPLUS.getCode();
	public static final int VARDECL=ProphecyAstTokenType.VARDECL.getCode();
	public static final int WHILE=ProphecyAstTokenType.WHILE.getCode();
